9 3 1 5 8 3 10 6 7 4
5 8 1 1 10 3 8 7 10 2
4 2 6 9 3 3 1 10 10 7
5 7 2 3 6 1 4 8 10 10
3 4 7 9 2 10 5 4 8 6
5 2 6 7 5 6 1 9 5 3
7 4 5 10 9 10 3 6 1 8
6 6 2 4 7 5 7 10 5 1
1 10 9 10 5 7 6 1 3 8
8 10 4 6 1 6 2 3 9 9