1 7 1 6 1 8 1 2
2 2 1 3 5 4 7 8
4 3 7 8 1 3 2 6
3 8 6 2 4 2 1 2
6 3 2 4 7 3 8 5
4 4 7 7 8 6 2 1
5 1 8 7 2 3 6 1
2 2 7 1 1 5 4 1
